* *******
* **    *
* ** ** *
*    ** *
* ***** *
* ** ****
*      X*
*********