***********
*         *
* ** **** *
* *     * *
* ** ** * *
* ** **** *
*  *   X* *
********* *
*         *
* *********